~~~~~~~~~~~~~
~...........~
~=======.===~
~......=....~
~..=.....=..~
~..=..=..=..~
~~~~~~~~~~~~~
