~~~~~~~~~~~~~
~========...~
~...........~
~...........~
~....===....~
~.....==....~
~~~~~~~~~~~~~

