~~~~~~~~~~~~~
~.=.=.....=.~
~.....=.....~
~=.==...===.~
~..=..=.==..~
~....==....=~
~~~~~~~~~~~~~